
11111111111111111111111111111111111111111111111111
11111111111111111111111111111111111111111111111111
11111111111111111111111111111111111111111111111111
11111111111111111111111111111111111111111111111111
11111111111111111111111111111111111111111111111111
11111111111111111111111111111111111111111111111111
11111111111111111111111111111111111111111111111111
11111111111111111111111111111111111111111111111111
11111111111111111111111111111111111111111111111111
11111111111111111111111111111111111111111111111111
11111000000011111111111111111111111111111111111111
11111000000011111111111111111111111111111111111111
11111000000011111111111111111111111111111111111111
11111000000010000001111111111111111111111111111111
11111000000010000001111111111111111111111111111111
11111000000010000001111111111111111111111111111111
11111000000010000001111111111111111111111111111111
11111000000010000001111111111111111111111111111111
11111000000010000001111111111111111111111111111111
11111111100000011111111111111111111111111111111111
11111111100000011111111111111111111111111111111111
11111111100000011111111111111111111111111111111111
11111111100000011111111111111111111111111111111111
11111111100000011111111111111111111111111111111111
11111111111111111111111111111111111111111111111111
11111111100000011111111111111111111111111111111111
11111111100000011111111111111111111111111111111111
11111111100000011111111111111111111111111111111111
11111111100000011111111111111111111111111111111111
11111111100000011111111111111111111111111111111111
11111111111111111111111111111111111111111111111111
11111111111111111111111111111111111111111111111111
11111111111111111111111111111111111111111111111111
11111111111111111111111111111111111111111111111111
11111111111111111111111111111111111111111111111111
11111111111111111111111111111111111111111111111111
11111111111111111111111111111111111111111111111111
11111111111111111111111111111111111111111111111111
11111111111111111111111111111111111111111111111111
11111111111111111111111111111111111111111111111111
11111111111111111111111111111111111111111111111111
11111111111111111111111111111111111111111111111111
11111111111111111111111111111111111111111111111111
11111111111111111111111111111111111111111111111111
11111111111111111111111111111111111111111111111111
11111111111111111111111111111111111111111111111111
11111111111111111111111111111111111111111111111111
11111111111111111111111111111111111111111111111111
11111111111111111111111111111111111111111111111111
11111111111111111111111111111111111111111111111111